Karakter:Gargamel,Kapı:C
Karakter:Azman,Kapı:B
0001000000100
0111101111110
0101111110010
0111101011010
0101001010010
1101111010110
0100111011110
0101111111111
0101000001110
0111111111110
0001000000000